22 24
002 002 002 002 002 002 002 002 002 002 002 002 002 002 002 002 002 002 002 002 002 002
002 001 001 001 001 001 001 001 003 003 003 003 002 001 001 001 001 001 001 001 001 002
002 001 001 003 001 001 001 001 003 003 001 001 001 001 001 002 001 001 001 001 001 002
002 001 001 003 003 003 003 001 001 001 001 001 001 001 001 001 001 001 001 001 001 002
002 001 001 001 003 003 001 001 001 001 001 001 001 001 001 001 001 001 001 001 001 002
002 001 001 001 001 003 003 001 001 001 001 001 001 001 001 001 001 001 001 001 001 002
002 001 001 002 001 003 003 001 002 001 001 001 001 001 001 001 001 001 001 001 001 002
002 002 001 001 001 001 001 003 002 002 001 001 001 001 001 003 001 001 001 001 001 002
002 001 001 001 001 001 001 003 002 002 001 001 001 001 001 003 001 001 001 001 001 002
002 001 001 002 001 001 001 001 002 002 001 001 001 001 001 001 001 001 001 001 001 002
002 001 001 001 001 001 001 001 002 001 001 001 001 001 001 001 001 001 001 001 001 002
002 001 001 001 001 001 001 001 001 001 001 001 001 001 002 002 001 001 001 001 001 002
002 000 000 000 000 000 001 001 000 000 000 000 000 000 000 000 000 000 000 001 001 002
000 000 000 000 000 000 000 000 000 000 000 000 000 000 000 000 000 000 000 001 001 002
000 000 000 000 000 000 000 000 000 000 000 000 000 000 000 000 000 000 000 001 001 000
000 000 000 000 000 000 000 000 000 000 000 000 000 000 000 000 000 000 000 001 001 000
000 000 000 000 000 000 000 000 000 000 000 000 000 000 000 000 000 000 000 001 001 000
000 000 000 000 000 000 000 000 000 000 000 000 000 000 000 000 000 000 000 001 001 000
000 000 000 000 000 000 000 000 000 000 000 000 000 000 000 000 000 000 000 001 001 000
000 000 000 000 000 000 000 000 000 000 000 000 000 000 000 000 000 000 000 001 001 000
000 000 000 000 000 000 000 000 000 000 000 000 000 000 000 000 000 000 000 001 001 000
000 000 000 000 000 000 000 000 000 000 000 000 000 000 000 000 000 000 000 001 001 000
000 000 000 000 000 000 000 000 000 000 000 000 000 000 000 000 000 000 000 001 001 000
000 000 000 000 000 000 000 000 000 000 000 000 000 000 000 000 000 000 000 001 001 000