24 26
002 002 002 002 002 002 002 002 002 002 002 002 002 002 002 002 002 002 002 002 002 002 002 002
002 001 001 001 001 001 001 001 003 003 003 003 002 001 001 001 001 001 001 001 001 001 001 002
002 001 001 003 001 001 001 001 003 003 001 001 001 001 001 002 001 001 001 001 001 001 001 002
002 001 001 003 003 003 003 001 001 001 001 001 001 001 001 001 001 001 001 001 001 001 001 002
002 001 001 001 003 003 001 001 001 001 001 001 001 001 001 001 001 001 001 001 001 001 001 002
002 001 001 001 001 003 003 001 001 001 001 001 001 001 001 001 001 001 001 001 001 001 001 002
002 001 001 002 001 003 003 001 002 001 001 001 001 001 001 001 001 001 001 001 001 001 001 002
002 002 001 001 001 001 001 003 002 002 001 001 001 001 001 003 001 001 001 001 001 001 001 002
002 001 001 001 001 001 001 003 002 002 001 001 001 001 001 003 001 001 001 001 001 001 001 002
002 001 001 002 001 001 001 001 002 002 001 001 001 001 001 001 001 001 001 001 001 001 001 002
002 001 001 001 001 001 001 001 002 001 001 001 001 001 001 001 001 001 001 001 001 001 001 002
002 001 001 001 001 001 001 001 001 008 008 008 001 001 002 002 001 001 008 008 001 001 001 002
002 001 001 001 001 001 001 001 001 008 003 008 002 002 002 002 001 008 003 008 001 001 001 002
002 001 001 001 001 001 001 003 001 008 003 008 002 001 002 002 002 008 003 008 001 001 001 002
002 001 001 001 003 003 003 003 001 003 003 008 001 001 001 002 002 003 003 008 001 001 001 002
002 001 001 001 001 001 001 001 001 003 003 008 001 001 001 002 002 003 008 008 001 001 001 002
002 001 001 001 001 001 003 001 003 003 003 003 001 001 001 001 002 008 008 001 001 001 001 002
002 001 001 001 001 001 001 003 003 003 003 003 002 001 001 001 002 002 001 001 001 001 001 002
002 001 001 001 001 001 002 002 002 001 001 001 001 003 001 001 002 002 001 001 001 001 001 002
002 001 001 001 001 001 001 001 002 003 003 003 002 003 003 001 001 001 001 001 001 001 001 002
002 001 001 001 001 001 001 001 001 001 003 003 001 001 003 001 001 001 001 001 001 001 001 001
002 001 001 001 001 001 001 001 001 001 001 003 001 001 001 001 001 001 001 001 001 001 001 001
002 001 001 001 001 001 001 001 001 001 008 003 001 001 001 001 001 001 001 001 001 001 001 001
002 008 008 008 008 008 008 008 008 008 003 008 002 002 002 002 001 001 001 001 001 001 001 001
002 003 003 003 003 003 003 003 003 003 003 003 008 001 001 001 001 001 001 001 001 001 001 001
002 002 002 002 002 002 002 002 002 002 002 002 002 002 002 002 002 002 002 002 002 002 002 002