40 30
002 002 002 002 002 002 002 002 002 002 002 002 002 002 002 002 002 002 002 002 002 002 002 002 002 002 002 002 002 002 002 002 002 002 002 002 002 002 002 002 
002 001 001 001 001 001 001 001 003 003 003 003 002 001 001 001 001 001 001 002 002 001 001 001 001 001 001 001 003 003 003 003 002 001 001 001 001 001 001 002 
002 001 001 003 001 001 001 001 003 003 001 001 001 001 001 002 001 001 001 002 002 001 001 003 001 001 001 001 003 003 001 001 001 001 001 002 001 001 001 002 
002 001 001 003 003 003 003 001 001 001 001 001 001 001 001 001 001 001 001 002 002 001 001 003 003 003 003 001 001 001 001 001 001 001 001 001 001 001 001 002 
002 001 001 001 003 003 001 001 001 001 001 001 001 001 001 001 001 001 001 002 002 001 001 001 003 003 001 001 001 001 001 001 001 001 001 001 001 001 001 002 
002 001 001 001 001 003 003 001 001 001 001 001 001 001 001 001 001 001 001 002 002 001 001 001 001 003 003 001 001 001 001 001 001 001 001 001 001 001 001 002 
002 001 001 002 001 003 003 001 002 001 001 001 001 001 001 001 001 001 001 002 002 001 001 002 001 003 003 001 002 001 001 001 001 001 001 001 001 001 001 002 
002 002 001 001 001 001 001 003 002 002 001 001 001 001 001 003 001 001 001 002 002 002 001 001 001 001 001 003 002 002 001 001 001 001 001 003 001 001 001 002 
002 001 001 001 001 001 001 003 002 002 001 001 001 001 001 003 001 001 001 002 002 001 001 001 001 001 001 003 002 002 001 001 001 001 001 003 001 001 001 002 
002 001 001 002 001 001 001 001 002 001 001 001 001 001 001 001 001 001 001 002 002 001 001 002 001 001 001 001 002 001 001 001 001 001 001 001 001 001 001 002 
002 001 001 001 001 001 001 001 001 001 001 001 001 001 001 001 001 001 001 002 002 001 001 001 001 001 001 001 001 001 001 001 001 001 001 001 001 001 001 002 
002 001 001 001 001 001 001 004 005 001 001 001 001 001 002 002 001 001 001 002 002 001 001 001 001 001 001 004 005 001 001 001 001 001 002 002 001 001 001 002 
002 001 001 001 001 001 001 006 007 001 003 001 001 002 002 002 001 002 003 002 002 001 001 001 001 001 001 006 007 001 003 001 001 002 002 002 001 002 003 002 
002 001 001 001 001 001 001 003 001 001 003 001 002 002 002 002 002 002 003 002 002 001 001 001 001 001 001 003 001 001 003 001 002 002 002 002 002 002 003 002 
002 001 001 001 003 003 003 003 001 003 003 001 001 002 002 001 002 003 003 002 002 001 001 001 003 003 003 003 001 003 003 001 001 002 002 001 002 003 003 002 
002 001 001 001 001 001 001 001 001 003 003 003 001 001 001 002 002 003 003 002 002 001 001 001 001 001 001 001 001 003 003 003 001 001 001 002 002 003 003 002 
002 001 001 001 001 001 003 001 003 003 003 003 001 001 001 001 002 002 003 002 002 001 001 001 001 001 003 001 003 003 003 003 001 001 001 001 002 002 003 002 
002 001 001 001 001 001 001 003 003 003 003 003 003 001 001 001 002 002 001 002 002 001 001 001 001 001 001 003 003 003 003 003 003 001 001 001 002 002 001 002 
002 001 001 001 001 001 002 002 002 001 001 001 003 003 001 001 002 002 001 002 002 001 001 001 001 001 002 002 002 001 001 001 003 003 001 001 002 002 001 002 
002 001 001 001 001 001 001 001 002 003 003 001 001 001 001 001 001 001 001 002 002 001 001 001 001 001 001 001 002 003 003 001 001 001 001 001 001 001 001 002 
001 001 001 001 001 001 001 001 001 001 003 001 001 001 003 001 001 001 001 002 001 001 001 001 001 001 001 001 001 001 003 001 001 001 003 001 001 001 001 002 
001 001 001 001 001 001 001 001 001 001 001 001 001 001 001 001 001 001 001 002 001 001 001 001 001 001 001 001 001 001 001 001 001 001 001 001 001 001 001 002 
001 001 001 001 001 001 001 001 001 001 001 003 001 001 001 001 001 001 001 002 001 001 001 001 001 001 001 001 001 001 001 003 001 001 001 001 001 001 001 002 
001 001 001 001 001 001 001 003 001 001 003 001 002 002 002 002 002 002 003 002 001 001 001 001 001 001 001 003 001 001 003 001 002 002 002 002 002 002 003 002 
001 003 003 003 003 003 003 003 003 003 003 003 001 001 001 001 001 001 001 002 001 003 003 003 003 003 003 003 003 003 003 003 001 001 001 001 001 001 001 002 
001 003 003 003 003 003 003 003 003 003 003 003 001 001 001 001 001 001 001 002 001 003 003 003 003 003 003 003 003 003 003 003 001 001 001 001 001 001 001 002 
001 001 001 001 001 001 001 001 001 001 001 003 001 001 001 001 001 001 001 002 001 001 001 001 001 001 001 001 001 001 001 003 001 001 001 001 001 001 001 002 
001 001 001 001 001 001 001 003 001 001 003 001 002 002 002 002 002 002 003 002 001 001 001 001 001 001 001 003 001 001 003 001 002 002 002 002 002 002 003 002 
001 003 003 003 003 003 003 003 003 003 003 003 001 001 001 001 001 001 001 002 001 003 003 003 003 003 003 003 003 003 003 003 001 001 001 001 001 001 001 002 
002 002 002 002 002 002 002 002 002 002 002 002 002 002 002 002 002 002 002 002 002 002 002 002 002 002 002 002 002 002 002 002 002 002 002 002 002 002 002 002 